NO ./textures/wall_north.xpm
SO ./textures/wall_south.xpm
WE ./textures/wall_west.xpm
EA ./textures/wall_east.xpm
F 255,0,0
C 0,255,0

111111111
100000001
101111101
101W00101
101001101
100000001
111111111
