NO ./textures/wall_north.xpm
SO ./textures/wall_south.xpm
WE ./textures/wall_west.xpm
EA ./textures/wall_east.xpm
F 255,0,0
C 0,255,0

11111
1N0S1
1W0E1
11111
