NO ./textures/rocky.xpm
SO ./textures/rocky.xpm
WE ./textures/ciel.xpm
EA ./textures/ciel.xpm

C 173,216,230
F 224,205,169

111111111111111111111111111111111111111
100000000000000000000000000000000000001
100111111000111111001111111001100000001
1W1100000000001100001100000001100000001
101100000000001100001100000001100000001
101100000000001100001100000001100000001
101100000000001100001111110001100000001
101100000000001100001100000001100000001
101100000000001100001000000001100000001
101100000000001100001100000001100000001
100111111000111111001111111001111111101
100000000000000000000000000000000000001
111111111111111111111111111111111111111
