NO ./textures/rocky.xpm
SO ./textures/rocky.xpm
WE ./textures/ciel.xpm
EA ./textures/ciel.xpm

C 173,216,230
F 224,205,169


        11111111111111111111111111
        1000000000110000000000001
        10110000011100000000000011
        1001000000000000000000001
111111111011000001110000000000001
100000000011000001110111111111111
11110111111111011100000010001
11110111111111011101010010001
11000000110101011100000010001
10000000000000001100000010001
10000000000000000001010010101
110000011101010111110110000N1
11110111 1110101 101111010001
11111111 1111111 111111111111
