NO ./textures/wall_north.xpm
SO ./textures/wall_south.xpm
WE ./textures/wall_west.xpm
EA ./textures/wall_east.xpm
F 999999999,0,0
C 0,4294967295,0

1111
1W01
1111
