NO ./textures/ciel.xpm
SO ./textures/ciel.xpm
WE ./textures/ciel.xpm
EA ./textures/ciel.xpm
garbage
F 18,53,25
C 153,204,255

  11111
  10W01
  11111
